450,451,452,250,0,0,0,0,0,0,0,6674,0,0,0,0,0,0,0,0,0,0,0,0,0,0,0,0,0,0,
552,553,554,352,0,0,0,0,0,0,0,6674,0,0,0,0,0,677,677,677,677,677,677,677,677,0,0,0,0,250,
556,0,0,0,0,0,6573,6775,6775,6775,6775,6776,0,0,0,0,0,6876,348,349,350,0,0,0,6878,0,0,0,0,352,
6775,6775,6775,6775,6775,6775,6776,0,0,0,0,0,0,0,677,677,677,6978,450,451,452,0,0,0,6980,677,677,677,0,0,
0,0,0,0,0,0,0,0,0,0,0,0,0,6876,0,4113,4114,0,552,553,554,0,0,0,42,43,44,6878,0,0,
0,0,0,0,0,0,0,0,0,0,42,43,44,6978,4214,4215,4216,4217,0,0,0,0,0,0,144,145,146,6980,0,0,
0,0,0,0,0,0,0,0,0,6876,144,145,146,6676,4316,4317,4318,4319,1294,1294,1295,0,0,0,246,247,248,6980,677,0,
0,0,0,0,0,0,0,0,0,6978,246,247,248,0,4418,4419,4420,4421,352,0,1397,0,0,0,0,0,0,0,6878,677,
0,0,0,0,0,0,0,0,0,6978,0,0,0,249,2709,2710,2710,2711,152,0,1397,0,4113,4114,0,0,348,349,350,0,
0,0,0,0,0,42,43,44,677,6978,257,0,0,351,2709,0,2710,2711,0,0,1499,4214,4215,4216,4217,0,450,451,452,0,
0,0,0,0,6876,144,145,146,0,0,0,0,0,0,0,0,1554,1555,0,0,0,4316,4317,4318,4319,0,552,553,554,0,
0,0,0,0,6978,246,247,248,0,0,0,0,0,0,0,0,0,0,0,0,0,4418,4419,4420,4421,0,0,0,351,0,
677,677,249,677,6978,0,0,0,0,0,0,0,0,0,0,0,0,0,0,0,765,2709,2710,2710,2711,0,6879,7081,7081,7081,
1561,0,352,0,0,0,0,0,0,0,0,0,0,0,0,0,0,0,0,0,765,2709,2710,0,2711,0,6980,677,0,0,
0,0,0,0,0,0,0,0,0,0,4414,4415,4416,348,349,350,0,0,0,0,0,0,0,0,0,0,6980,0,0,0,
0,0,0,0,0,0,0,0,0,0,2709,0,2711,450,451,452,0,33,35,0,0,0,0,0,0,0,6980,0,0,0,
0,0,882,0,0,0,0,0,0,0,0,0,0,552,553,554,0,135,137,0,0,0,678,0,0,0,6980,0,0,0,
7081,7081,7081,7081,7081,6880,249,0,0,0,0,0,0,0,0,0,0,0,341,0,0,0,0,6879,7081,7081,7082,0,0,0,
0,0,0,0,0,6978,351,0,0,555,0,0,0,0,0,0,0,0,0,0,0,0,0,6980,0,0,0,0,0,0,
0,0,0,0,0,7080,7081,7081,7081,6880,0,175,176,177,0,0,0,0,0,0,0,0,0,6980,0,0,0,0,0,0,
0,0,0,0,0,0,0,0,0,6978,0,277,278,279,0,0,0,0,0,0,250,0,0,6980,0,0,0,0,0,0,
0,0,0,0,0,0,0,0,0,7080,7081,7081,7081,7081,6880,0,0,0,362,0,352,6879,7081,7082,0,0,0,0,0,0,
0,0,0,0,0,0,0,0,0,0,0,0,0,677,6978,0,0,0,6879,7081,7081,7082,0,0,0,0,0,0,0,0,
0,0,0,0,0,0,0,0,0,0,0,0,0,0,7080,0,0,0,7082,0,0,0,0,0,0,0,0,0,0,0,
0,0,0,0,0,0,0,0,0,0,0,0,0,0,677,0,0,0,677,0,0,0,0,0,0,0,0,0,0,0,
0,0,0,0,0,0,0,0,0,0,0,0,0,0,677,0,0,0,677,0,0,0,0,0,0,0,0,0,0,0,
6571,6571,6571,6571,6571,348,349,350,6571,6572,0,0,0,0,677,0,0,0,677,0,0,0,0,0,0,0,0,0,0,0,
348,349,350,0,0,450,451,452,0,6674,0,0,0,0,677,0,0,0,677,0,0,0,0,0,0,0,0,0,0,0,
450,451,452,0,0,552,553,554,0,6675,6571,6571,6571,6571,6571,0,0,0,6571,6571,6571,6571,6572,0,0,0,0,0,0,0,
552,553,554,0,0,0,0,0,0,0,0,0,0,0,0,0,0,0,348,349,350,0,6674,0,0,0,0,0,0,0,